XXXXXXXXXXXXXXXXXXXXXXXXXXXXXXXXXXXXXXXXXXXXXXXXXXXXXXXXXXXXXXXX
X                                                              X
X                                                              X
X                                                              X
X                                                              X
X                                                              X
X              XXXXXXXXXXXXXXXXXXXXXXXXXXXXXXXXXX              X
X              XXXXXXXXXXXXXXXXXXXXXXXXXXXXXXXXXX              X
X              XX                                              X
X              XX                                              X
X              XX                                              X
X              XX                                              X
X              XX                                              X
X                                                              X
X                                                              X
X                                                              X
X                                                              X
X                                                              X
X                                              XX              X
X                                              XX              X
X                                              XX              X
X                                              XX              X
X                                              XX              X
X              XXXXXXXXXXXXXXXXXXXXXXXXXXXXXXXXXX              X
X              XXXXXXXXXXXXXXXXXXXXXXXXXXXXXXXXXX              X
X                                                              X
X                                                              X
X                                                              X
X                                                              X
X                                                              X
X                                                              X
XXXXXXXXXXXXXXXXXXXXXXXXXXXXXXXXXXXXXXXXXXXXXXXXXXXXXXXXXXXXXXXX
